....................
......@..@..@..@....
......@..@..@..@....
....................
.....(......########
.....=......########
.....=......########
.....=......########
.....)......########
....................
....................